11011111
10000001
10111101
00000001
10101001
10001001
11111111